[
  [  0,  0,  0,  0,  3,  1,  2,  0,  0,  0,  0,  0,  0,  0,  0,  0,  0,  0,  0,  0,  0,  0],
  [  0,  0,  0,  0,  3,  1,  2,  0,  0,  0,  0,  0,  0,  0,  0,  0,  0,  0,  0,  0,  0,  0],
  [  0,  0,  0,  0,  3,  1,  2,  0,  0,  0,  0,  0,  0,  0,  0,  0,  0,  0,  0,  0,  0,  0],
  [  0,  0,  0,  0,  3,  1,  2,  0,  0,  0,  0,  0,  0,  0,  0,  0,  0,  0,  0,  0,  0,  0],
  [  0,  0,  0,  0,  3,  1,  5,  7,  7,  7,  7,  7,  7,  7,  0,  0,  0,  0,  0,  0,  0,  0],
  [  0,  0,  0,  0,  3,  1,  1,  1,  1,  1,  1,  1,  1,  1,  0,  0,  0,  0,  0,  0,  0,  0],
  [  0,  0,  0,  0,  3,  1,  4,  6,  6,  6,  6,  6,  6,  6,  0,  0,  0,  0,  0,  0,  0,  0],
  [  0,  0,  0,  0,  3,  1,  5,  7,  7,  7,  7,  7,  7,  7,  0,  0,  0,  0,  0,  0,  0,  0],
  [  0,  0,  0,  0,  3,  1,  1,  1,  1,  1,  1,  1,  1,  1,  0,  0,  0,  0,  0,  0,  0,  0],
  [  0,  0,  0,  0,  0,  6,  6,  6,  6,  6,  6,  6,  6,  6,  0,  0,  0,  0,  0,  0,  0,  0]
]