{
  "tileset": "ts1",
  "cols": 61,
  "rows": 61,
  "encoding": "matrix",
  "data": [
    [43, 43, 43, 43, 43, 43, 43, 43, 43, 43, 43, 43, 43, 43, 43, 43, 43, 43, 43, 43, 43, 43, 43, 43, 43, 43, 43, 43, 43, 43, 43, 43, 43, 43, 43, 43, 43, 43, 43, 43, 43, 43, 43, 43, 43, 43, 43, 43, 43, 43, 43, 43, 43, 43, 43, 43, 43, 43, 43, 43, 43],
    [43, 81, 81, 81, 81, 81, 43, 81, 81, 81, 81, 81, 81, 81, 81, 81, 81, 81, 81, 81, 81, 81, 81, 81, 43, 81, 81, 81, 81, 81, 81, 81, 81, 81, 81, 81, 81, 81, 81, 81, 81, 81, 81, 81, 81, 81, 81, 81, 81, 81, 81, 81, 81, 81, 81, 81, 81, 81, 81, 81, 43],
    [43, 81, 81, 81, 81, 81, 43, 81, 81, 81, 81, 81, 81, 81, 81, 81, 81, 81, 81, 81, 81, 81, 81, 81, 43, 81, 81, 81, 81, 81, 81, 81, 81, 81, 81, 81, 81, 81, 81, 81, 81, 81, 81, 81, 81, 81, 81, 81, 81, 81, 81, 81, 81, 81, 81, 81, 81, 81, 81, 81, 43],
    [43, 81, 81, 81, 81, 81, 43, 81, 81, 81, 81, 81, 81, 81, 81, 81, 81, 81, 81, 81, 81, 81, 81, 81, 43, 81, 81, 81, 81, 81, 81, 81, 81, 81, 81, 81, 81, 81, 81, 81, 81, 81, 81, 81, 81, 81, 81, 81, 81, 81, 81, 81, 81, 81, 81, 81, 81, 81, 81, 81, 43],
    [43, 81, 81, 81, 81, 81, 43, 81, 81, 81, 81, 81, 81, 81, 81, 81, 81, 81, 81, 81, 81, 81, 81, 81, 43, 81, 81, 81, 81, 81, 81, 81, 81, 81, 81, 81, 81, 81, 81, 81, 81, 81, 81, 81, 81, 81, 81, 81, 81, 81, 81, 81, 81, 81, 81, 81, 81, 81, 81, 81, 43],
    [43, 81, 81, 81, 81, 81, 43, 81, 81, 81, 81, 81, 81, 81, 81, 81, 81, 81, 81, 81, 81, 81, 81, 81, 43, 81, 81, 81, 81, 81, 81, 81, 81, 81, 81, 81, 81, 81, 81, 81, 81, 81, 81, 81, 81, 81, 81, 81, 81, 81, 81, 81, 81, 81, 81, 81, 81, 81, 81, 81, 43],
    [43, 81, 81, 81, 81, 81, 43, 81, 81, 81, 81, 81, 43, 43, 43, 43, 43, 43, 43, 81, 81, 81, 81, 81, 43, 81, 81, 81, 81, 81, 43, 43, 43, 43, 43, 43, 43, 43, 43, 43, 43, 43, 43, 81, 81, 81, 81, 81, 43, 43, 43, 43, 43, 43, 43, 81, 81, 81, 81, 81, 43],
    [43, 81, 81, 81, 81, 81, 81, 81, 81, 81, 81, 81, 43, 81, 81, 81, 81, 81, 81, 81, 81, 81, 81, 81, 43, 81, 81, 81, 81, 81, 43, 81, 81, 81, 81, 81, 43, 81, 81, 81, 81, 81, 81, 81, 81, 81, 81, 81, 43, 81, 81, 81, 81, 81, 81, 81, 81, 81, 81, 81, 43],
    [43, 81, 81, 81, 81, 81, 81, 81, 81, 81, 81, 81, 43, 81, 81, 81, 81, 81, 81, 81, 81, 81, 81, 81, 43, 81, 81, 81, 81, 81, 43, 81, 81, 81, 81, 81, 43, 81, 81, 81, 81, 81, 81, 81, 81, 81, 81, 81, 43, 81, 81, 81, 81, 81, 81, 81, 81, 81, 81, 81, 43],
    [43, 81, 81, 81, 81, 81, 81, 81, 81, 81, 81, 81, 43, 81, 81, 81, 81, 81, 81, 81, 81, 81, 81, 81, 43, 81, 81, 81, 81, 81, 43, 81, 81, 81, 81, 81, 43, 81, 81, 81, 81, 81, 81, 81, 81, 81, 81, 81, 43, 81, 81, 81, 81, 81, 81, 81, 81, 81, 81, 81, 43],
    [43, 81, 81, 81, 81, 81, 81, 81, 81, 81, 81, 81, 43, 81, 81, 81, 81, 81, 81, 81, 81, 81, 81, 81, 43, 81, 81, 81, 81, 81, 43, 81, 81, 81, 81, 81, 43, 81, 81, 81, 81, 81, 81, 81, 81, 81, 81, 81, 43, 81, 81, 81, 81, 81, 81, 81, 81, 81, 81, 81, 43],
    [43, 81, 81, 81, 81, 81, 81, 81, 81, 81, 81, 81, 43, 81, 81, 81, 81, 81, 81, 81, 81, 81, 81, 81, 43, 81, 81, 81, 81, 81, 43, 81, 81, 81, 81, 81, 43, 81, 81, 81, 81, 81, 81, 81, 81, 81, 81, 81, 43, 81, 81, 81, 81, 81, 81, 81, 81, 81, 81, 81, 43],
    [43, 43, 43, 43, 43, 43, 43, 43, 43, 43, 43, 43, 43, 81, 81, 81, 81, 81, 43, 81, 81, 81, 81, 81, 43, 81, 81, 81, 81, 81, 43, 81, 81, 81, 81, 81, 43, 81, 81, 81, 81, 81, 43, 43, 43, 43, 43, 43, 43, 81, 81, 81, 81, 81, 43, 43, 43, 43, 43, 43, 43],
    [43, 81, 81, 81, 81, 81, 81, 81, 81, 81, 81, 81, 81, 81, 81, 81, 81, 81, 43, 81, 81, 81, 81, 81, 43, 81, 81, 81, 81, 81, 43, 81, 81, 81, 81, 81, 43, 81, 81, 81, 81, 81, 43, 81, 81, 81, 81, 81, 81, 81, 81, 81, 81, 81, 81, 81, 81, 81, 81, 81, 43],
    [43, 81, 81, 81, 81, 81, 81, 81, 81, 81, 81, 81, 81, 81, 81, 81, 81, 81, 43, 81, 81, 81, 81, 81, 43, 81, 81, 81, 81, 81, 43, 81, 81, 81, 81, 81, 43, 81, 81, 81, 81, 81, 43, 81, 81, 81, 81, 81, 81, 81, 81, 81, 81, 81, 81, 81, 81, 81, 81, 81, 43],
    [43, 81, 81, 81, 81, 81, 81, 81, 81, 81, 81, 81, 81, 81, 81, 81, 81, 81, 43, 81, 81, 81, 81, 81, 43, 81, 81, 81, 81, 81, 43, 81, 81, 81, 81, 81, 43, 81, 81, 81, 81, 81, 43, 81, 81, 81, 81, 81, 81, 81, 81, 81, 81, 81, 81, 81, 81, 81, 81, 81, 43],
    [43, 81, 81, 81, 81, 81, 81, 81, 81, 81, 81, 81, 81, 81, 81, 81, 81, 81, 43, 81, 81, 81, 81, 81, 43, 81, 81, 81, 81, 81, 43, 81, 81, 81, 81, 81, 43, 81, 81, 81, 81, 81, 43, 81, 81, 81, 81, 81, 81, 81, 81, 81, 81, 81, 81, 81, 81, 81, 81, 81, 43],
    [43, 81, 81, 81, 81, 81, 81, 81, 81, 81, 81, 81, 81, 81, 81, 81, 81, 81, 43, 81, 81, 81, 81, 81, 43, 81, 81, 81, 81, 81, 43, 81, 81, 81, 81, 81, 43, 81, 81, 81, 81, 81, 43, 81, 81, 81, 81, 81, 81, 81, 81, 81, 81, 81, 81, 81, 81, 81, 81, 81, 43],
    [43, 81, 81, 81, 81, 81, 43, 81, 81, 81, 81, 81, 43, 43, 43, 43, 43, 43, 43, 43, 43, 43, 43, 43, 43, 81, 81, 81, 81, 81, 43, 81, 81, 81, 81, 81, 43, 81, 81, 81, 81, 81, 43, 43, 43, 43, 43, 43, 43, 43, 43, 43, 43, 43, 43, 43, 43, 43, 43, 43, 43],
    [43, 81, 81, 81, 81, 81, 43, 81, 81, 81, 81, 81, 43, 81, 81, 81, 81, 81, 81, 81, 81, 81, 81, 81, 81, 81, 81, 81, 81, 81, 81, 81, 81, 81, 81, 81, 43, 81, 81, 81, 81, 81, 81, 81, 81, 81, 81, 81, 81, 81, 81, 81, 81, 81, 81, 81, 81, 81, 81, 81, 43],
    [43, 81, 81, 81, 81, 81, 43, 81, 81, 81, 81, 81, 43, 81, 81, 81, 81, 81, 81, 81, 81, 81, 81, 81, 81, 81, 81, 81, 81, 81, 81, 81, 81, 81, 81, 81, 43, 81, 81, 81, 81, 81, 81, 81, 81, 81, 81, 81, 81, 81, 81, 81, 81, 81, 81, 81, 81, 81, 81, 81, 43],
    [43, 81, 81, 81, 81, 81, 43, 81, 81, 81, 81, 81, 43, 81, 81, 81, 81, 81, 81, 81, 81, 81, 81, 81, 81, 81, 81, 81, 81, 81, 81, 81, 81, 81, 81, 81, 43, 81, 81, 81, 81, 81, 81, 81, 81, 81, 81, 81, 81, 81, 81, 81, 81, 81, 81, 81, 81, 81, 81, 81, 43],
    [43, 81, 81, 81, 81, 81, 43, 81, 81, 81, 81, 81, 43, 81, 81, 81, 81, 81, 81, 81, 81, 81, 81, 81, 81, 81, 81, 81, 81, 81, 81, 81, 81, 81, 81, 81, 43, 81, 81, 81, 81, 81, 81, 81, 81, 81, 81, 81, 81, 81, 81, 81, 81, 81, 81, 81, 81, 81, 81, 81, 43],
    [43, 81, 81, 81, 81, 81, 43, 81, 81, 81, 81, 81, 43, 81, 81, 81, 81, 81, 81, 81, 81, 81, 81, 81, 81, 81, 81, 81, 81, 81, 81, 81, 81, 81, 81, 81, 43, 81, 81, 81, 81, 81, 81, 81, 81, 81, 81, 81, 81, 81, 81, 81, 81, 81, 81, 81, 81, 81, 81, 81, 43],
    [43, 81, 81, 81, 81, 81, 43, 81, 81, 81, 81, 81, 43, 81, 81, 81, 81, 81, 43, 43, 43, 43, 43, 43, 43, 43, 43, 43, 43, 43, 43, 81, 81, 81, 81, 81, 43, 43, 43, 43, 43, 43, 43, 43, 43, 43, 43, 43, 43, 43, 43, 43, 43, 43, 43, 81, 81, 81, 81, 81, 43],
    [43, 81, 81, 81, 81, 81, 43, 81, 81, 81, 81, 81, 43, 81, 81, 81, 81, 81, 43, 81, 81, 81, 81, 81, 81, 81, 81, 81, 81, 81, 43, 81, 81, 81, 81, 81, 81, 81, 81, 81, 81, 81, 43, 81, 81, 81, 81, 81, 43, 81, 81, 81, 81, 81, 81, 81, 81, 81, 81, 81, 43],
    [43, 81, 81, 81, 81, 81, 43, 81, 81, 81, 81, 81, 43, 81, 81, 81, 81, 81, 43, 81, 81, 81, 81, 81, 81, 81, 81, 81, 81, 81, 43, 81, 81, 81, 81, 81, 81, 81, 81, 81, 81, 81, 43, 81, 81, 81, 81, 81, 43, 81, 81, 81, 81, 81, 81, 81, 81, 81, 81, 81, 43],
    [43, 81, 81, 81, 81, 81, 43, 81, 81, 81, 81, 81, 43, 81, 81, 81, 81, 81, 43, 81, 81, 81, 81, 81, 81, 81, 81, 81, 81, 81, 43, 81, 81, 81, 81, 81, 81, 81, 81, 81, 81, 81, 43, 81, 81, 81, 81, 81, 43, 81, 81, 81, 81, 81, 81, 81, 81, 81, 81, 81, 43],
    [43, 81, 81, 81, 81, 81, 43, 81, 81, 81, 81, 81, 43, 81, 81, 81, 81, 81, 43, 81, 81, 81, 81, 81, 81, 81, 81, 81, 81, 81, 43, 81, 81, 81, 81, 81, 81, 81, 81, 81, 81, 81, 43, 81, 81, 81, 81, 81, 43, 81, 81, 81, 81, 81, 81, 81, 81, 81, 81, 81, 43],
    [43, 81, 81, 81, 81, 81, 43, 81, 81, 81, 81, 81, 43, 81, 81, 81, 81, 81, 43, 81, 81, 81, 81, 81, 81, 81, 81, 81, 81, 81, 43, 81, 81, 81, 81, 81, 81, 81, 81, 81, 81, 81, 43, 81, 81, 81, 81, 81, 43, 81, 81, 81, 81, 81, 81, 81, 81, 81, 81, 81, 43],
    [43, 81, 81, 81, 81, 81, 43, 43, 43, 43, 43, 43, 43, 81, 81, 81, 81, 81, 43, 81, 81, 81, 81, 81, 43, 81, 81, 81, 81, 81, 43, 43, 43, 43, 43, 43, 43, 81, 81, 81, 81, 81, 43, 81, 81, 81, 81, 81, 43, 81, 81, 81, 81, 81, 43, 43, 43, 43, 43, 43, 43],
    [43, 81, 81, 81, 81, 81, 81, 81, 81, 81, 81, 81, 81, 81, 81, 81, 81, 81, 43, 81, 81, 81, 81, 81, 43, 81, 81, 81, 81, 81, 43, 81, 81, 81, 81, 81, 81, 81, 81, 81, 81, 81, 81, 81, 81, 81, 81, 81, 43, 81, 81, 81, 81, 81, 81, 81, 81, 81, 81, 81, 43],
    [43, 81, 81, 81, 81, 81, 81, 81, 81, 81, 81, 81, 81, 81, 81, 81, 81, 81, 43, 81, 81, 81, 81, 81, 43, 81, 81, 81, 81, 81, 43, 81, 81, 81, 81, 81, 81, 81, 81, 81, 81, 81, 81, 81, 81, 81, 81, 81, 43, 81, 81, 81, 81, 81, 81, 81, 81, 81, 81, 81, 43],
    [43, 81, 81, 81, 81, 81, 81, 81, 81, 81, 81, 81, 81, 81, 81, 81, 81, 81, 43, 81, 81, 81, 81, 81, 43, 81, 81, 81, 81, 81, 43, 81, 81, 81, 81, 81, 81, 81, 81, 81, 81, 81, 81, 81, 81, 81, 81, 81, 43, 81, 81, 81, 81, 81, 81, 81, 81, 81, 81, 81, 43],
    [43, 81, 81, 81, 81, 81, 81, 81, 81, 81, 81, 81, 81, 81, 81, 81, 81, 81, 43, 81, 81, 81, 81, 81, 43, 81, 81, 81, 81, 81, 43, 81, 81, 81, 81, 81, 81, 81, 81, 81, 81, 81, 81, 81, 81, 81, 81, 81, 43, 81, 81, 81, 81, 81, 81, 81, 81, 81, 81, 81, 43],
    [43, 81, 81, 81, 81, 81, 81, 81, 81, 81, 81, 81, 81, 81, 81, 81, 81, 81, 43, 81, 81, 81, 81, 81, 43, 81, 81, 81, 81, 81, 43, 81, 81, 81, 81, 81, 81, 81, 81, 81, 81, 81, 81, 81, 81, 81, 81, 81, 43, 81, 81, 81, 81, 81, 81, 81, 81, 81, 81, 81, 43],
    [43, 81, 81, 81, 81, 81, 43, 43, 43, 43, 43, 43, 43, 43, 43, 43, 43, 43, 43, 81, 81, 81, 81, 81, 43, 81, 81, 81, 81, 81, 43, 43, 43, 43, 43, 43, 43, 43, 43, 43, 43, 43, 43, 81, 81, 81, 81, 81, 43, 43, 43, 43, 43, 43, 43, 81, 81, 81, 81, 81, 43],
    [43, 81, 81, 81, 81, 81, 81, 81, 81, 81, 81, 81, 81, 81, 81, 81, 81, 81, 43, 81, 81, 81, 81, 81, 43, 81, 81, 81, 81, 81, 81, 81, 81, 81, 81, 81, 43, 81, 81, 81, 81, 81, 81, 81, 81, 81, 81, 81, 43, 81, 81, 81, 81, 81, 81, 81, 81, 81, 81, 81, 43],
    [43, 81, 81, 81, 81, 81, 81, 81, 81, 81, 81, 81, 81, 81, 81, 81, 81, 81, 43, 81, 81, 81, 81, 81, 43, 81, 81, 81, 81, 81, 81, 81, 81, 81, 81, 81, 43, 81, 81, 81, 81, 81, 81, 81, 81, 81, 81, 81, 43, 81, 81, 81, 81, 81, 81, 81, 81, 81, 81, 81, 43],
    [43, 81, 81, 81, 81, 81, 81, 81, 81, 81, 81, 81, 81, 81, 81, 81, 81, 81, 43, 81, 81, 81, 81, 81, 43, 81, 81, 81, 81, 81, 81, 81, 81, 81, 81, 81, 43, 81, 81, 81, 81, 81, 81, 81, 81, 81, 81, 81, 43, 81, 81, 81, 81, 81, 81, 81, 81, 81, 81, 81, 43],
    [43, 81, 81, 81, 81, 81, 81, 81, 81, 81, 81, 81, 81, 81, 81, 81, 81, 81, 43, 81, 81, 81, 81, 81, 43, 81, 81, 81, 81, 81, 81, 81, 81, 81, 81, 81, 43, 81, 81, 81, 81, 81, 81, 81, 81, 81, 81, 81, 43, 81, 81, 81, 81, 81, 81, 81, 81, 81, 81, 81, 43],
    [43, 81, 81, 81, 81, 81, 81, 81, 81, 81, 81, 81, 81, 81, 81, 81, 81, 81, 43, 81, 81, 81, 81, 81, 43, 81, 81, 81, 81, 81, 81, 81, 81, 81, 81, 81, 43, 81, 81, 81, 81, 81, 81, 81, 81, 81, 81, 81, 43, 81, 81, 81, 81, 81, 81, 81, 81, 81, 81, 81, 43],
    [43, 43, 43, 43, 43, 43, 43, 81, 81, 81, 81, 81, 43, 43, 43, 43, 43, 43, 43, 81, 81, 81, 81, 81, 43, 43, 43, 43, 43, 43, 43, 81, 81, 81, 81, 81, 43, 43, 43, 43, 43, 43, 43, 43, 43, 43, 43, 43, 43, 81, 81, 81, 81, 81, 43, 81, 81, 81, 81, 81, 43],
    [43, 81, 81, 81, 81, 81, 43, 81, 81, 81, 81, 81, 43, 81, 81, 81, 81, 81, 81, 81, 81, 81, 81, 81, 43, 81, 81, 81, 81, 81, 43, 81, 81, 81, 81, 81, 81, 81, 81, 81, 81, 81, 81, 81, 81, 81, 81, 81, 43, 81, 81, 81, 81, 81, 43, 81, 81, 81, 81, 81, 43],
    [43, 81, 81, 81, 81, 81, 43, 81, 81, 81, 81, 81, 43, 81, 81, 81, 81, 81, 81, 81, 81, 81, 81, 81, 43, 81, 81, 81, 81, 81, 43, 81, 81, 81, 81, 81, 81, 81, 81, 81, 81, 81, 81, 81, 81, 81, 81, 81, 43, 81, 81, 81, 81, 81, 43, 81, 81, 81, 81, 81, 43],
    [43, 81, 81, 81, 81, 81, 43, 81, 81, 81, 81, 81, 43, 81, 81, 81, 81, 81, 81, 81, 81, 81, 81, 81, 43, 81, 81, 81, 81, 81, 43, 81, 81, 81, 81, 81, 81, 81, 81, 81, 81, 81, 81, 81, 81, 81, 81, 81, 43, 81, 81, 81, 81, 81, 43, 81, 81, 81, 81, 81, 43],
    [43, 81, 81, 81, 81, 81, 43, 81, 81, 81, 81, 81, 43, 81, 81, 81, 81, 81, 81, 81, 81, 81, 81, 81, 43, 81, 81, 81, 81, 81, 43, 81, 81, 81, 81, 81, 81, 81, 81, 81, 81, 81, 81, 81, 81, 81, 81, 81, 43, 81, 81, 81, 81, 81, 43, 81, 81, 81, 81, 81, 43],
    [43, 81, 81, 81, 81, 81, 43, 81, 81, 81, 81, 81, 43, 81, 81, 81, 81, 81, 81, 81, 81, 81, 81, 81, 43, 81, 81, 81, 81, 81, 43, 81, 81, 81, 81, 81, 81, 81, 81, 81, 81, 81, 81, 81, 81, 81, 81, 81, 43, 81, 81, 81, 81, 81, 43, 81, 81, 81, 81, 81, 43],
    [43, 81, 81, 81, 81, 81, 43, 81, 81, 81, 81, 81, 43, 81, 81, 81, 81, 81, 43, 43, 43, 43, 43, 43, 43, 81, 81, 81, 81, 81, 43, 43, 43, 43, 43, 43, 43, 43, 43, 43, 43, 43, 43, 81, 81, 81, 81, 81, 43, 81, 81, 81, 81, 81, 43, 43, 43, 43, 43, 43, 43],
    [43, 81, 81, 81, 81, 81, 43, 81, 81, 81, 81, 81, 43, 81, 81, 81, 81, 81, 81, 81, 81, 81, 81, 81, 81, 81, 81, 81, 81, 81, 81, 81, 81, 81, 81, 81, 43, 81, 81, 81, 81, 81, 81, 81, 81, 81, 81, 81, 43, 81, 81, 81, 81, 81, 81, 81, 81, 81, 81, 81, 43],
    [43, 81, 81, 81, 81, 81, 43, 81, 81, 81, 81, 81, 43, 81, 81, 81, 81, 81, 81, 81, 81, 81, 81, 81, 81, 81, 81, 81, 81, 81, 81, 81, 81, 81, 81, 81, 43, 81, 81, 81, 81, 81, 81, 81, 81, 81, 81, 81, 43, 81, 81, 81, 81, 81, 81, 81, 81, 81, 81, 81, 43],
    [43, 81, 81, 81, 81, 81, 43, 81, 81, 81, 81, 81, 43, 81, 81, 81, 81, 81, 81, 81, 81, 81, 81, 81, 81, 81, 81, 81, 81, 81, 81, 81, 81, 81, 81, 81, 43, 81, 81, 81, 81, 81, 81, 81, 81, 81, 81, 81, 43, 81, 81, 81, 81, 81, 81, 81, 81, 81, 81, 81, 43],
    [43, 81, 81, 81, 81, 81, 43, 81, 81, 81, 81, 81, 43, 81, 81, 81, 81, 81, 81, 81, 81, 81, 81, 81, 81, 81, 81, 81, 81, 81, 81, 81, 81, 81, 81, 81, 43, 81, 81, 81, 81, 81, 81, 81, 81, 81, 81, 81, 43, 81, 81, 81, 81, 81, 81, 81, 81, 81, 81, 81, 43],
    [43, 81, 81, 81, 81, 81, 43, 81, 81, 81, 81, 81, 43, 81, 81, 81, 81, 81, 81, 81, 81, 81, 81, 81, 81, 81, 81, 81, 81, 81, 81, 81, 81, 81, 81, 81, 43, 81, 81, 81, 81, 81, 81, 81, 81, 81, 81, 81, 43, 81, 81, 81, 81, 81, 81, 81, 81, 81, 81, 81, 43],
    [43, 81, 81, 81, 81, 81, 43, 81, 81, 81, 81, 81, 43, 43, 43, 43, 43, 43, 43, 43, 43, 43, 43, 43, 43, 43, 43, 43, 43, 43, 43, 81, 81, 81, 81, 81, 43, 43, 43, 43, 43, 43, 43, 43, 43, 43, 43, 43, 43, 43, 43, 43, 43, 43, 43, 81, 81, 81, 81, 81, 43],
    [43, 81, 81, 81, 81, 81, 81, 81, 81, 81, 81, 81, 81, 81, 81, 81, 81, 81, 81, 81, 81, 81, 81, 81, 81, 81, 81, 81, 81, 81, 43, 81, 81, 81, 81, 81, 81, 81, 81, 81, 81, 81, 81, 81, 81, 81, 81, 81, 81, 81, 81, 81, 81, 81, 81, 81, 81, 81, 81, 81, 43],
    [43, 81, 81, 81, 81, 81, 81, 81, 81, 81, 81, 81, 81, 81, 81, 81, 81, 81, 81, 81, 81, 81, 81, 81, 81, 81, 81, 81, 81, 81, 43, 81, 81, 81, 81, 81, 81, 81, 81, 81, 81, 81, 81, 81, 81, 81, 81, 81, 81, 81, 81, 81, 81, 81, 81, 81, 81, 81, 81, 81, 43],
    [43, 81, 81, 81, 81, 81, 81, 81, 81, 81, 81, 81, 81, 81, 81, 81, 81, 81, 81, 81, 81, 81, 81, 81, 81, 81, 81, 81, 81, 81, 43, 81, 81, 81, 81, 81, 81, 81, 81, 81, 81, 81, 81, 81, 81, 81, 81, 81, 81, 81, 81, 81, 81, 81, 81, 81, 81, 81, 81, 81, 43],
    [43, 81, 81, 81, 81, 81, 81, 81, 81, 81, 81, 81, 81, 81, 81, 81, 81, 81, 81, 81, 81, 81, 81, 81, 81, 81, 81, 81, 81, 81, 43, 81, 81, 81, 81, 81, 81, 81, 81, 81, 81, 81, 81, 81, 81, 81, 81, 81, 81, 81, 81, 81, 81, 81, 81, 81, 81, 81, 81, 81, 43],
    [43, 81, 81, 81, 81, 81, 81, 81, 81, 81, 81, 81, 81, 81, 81, 81, 81, 81, 81, 81, 81, 81, 81, 81, 81, 81, 81, 81, 81, 81, 43, 81, 81, 81, 81, 81, 81, 81, 81, 81, 81, 81, 81, 81, 81, 81, 81, 81, 81, 81, 81, 81, 81, 81, 81, 81, 81, 81, 81, 81, 43],
    [43, 43, 43, 43, 43, 43, 43, 43, 43, 43, 43, 43, 43, 43, 43, 43, 43, 43, 43, 43, 43, 43, 43, 43, 43, 43, 43, 43, 43, 43, 43, 43, 43, 43, 43, 43, 43, 43, 43, 43, 43, 43, 43, 43, 43, 43, 43, 43, 43, 43, 43, 43, 43, 43, 43, 43, 43, 43, 43, 43, 43]
  ],
  "objects": [
    {
      "walkable": false,
      "tile": 21,
      "pos": [2, 2]
    }
  ]
}