{
  "tileset": "ts1",
  "cols": 61,
  "rows": 61,
  "encoding": "array",
  "data": [
44,44,44,44,44,44,44,44,44,44,44,44,44,44,44,44,44,44,44,44,44,44,44,44,44,44,44,44,44,44,44,44,44,44,44,44,44,44,44,44,44,44,44,44,44,44,44,44,44,44,44,44,44,44,44,44,44,44,44,44,44,
44,43,61,62,63,43,44,43,43,43,43,43,43,43,43,43,61,62,62,62,63,43,43,43,44,43,43,43,43,43,43,43,43,43,43,61,62,62,63,61,62,62,62,63,43,43,61,62,62,62,62,62,62,62,63,43,43,43,43,43,44,
44,43,81,41,84,63,44,43,43,61,62,62,62,62,63,61,85,82,41,82,84,62,63,43,44,43,43,61,62,62,62,62,62,62,62,85,82,82,83,81,82,41,82,83,43,61,85,82,82,82,41,82,82,41,84,62,62,62,63,43,44,
44,43,81,82,41,83,44,43,61,85,82,82,41,82,83,81,82,41,41,41,82,82,83,43,44,43,61,85,82,41,82,82,41,82,82,82,82,64,103,101,102,65,82,84,62,85,41,41,82,82,82,41,41,82,41,82,41,41,84,63,44,
44,43,81,41,82,83,44,61,85,41,41,82,64,102,103,101,102,102,102,65,82,82,83,43,44,43,81,82,41,41,64,102,102,102,102,65,41,83,43,43,43,81,82,82,82,41,82,64,65,41,41,64,102,102,102,102,65,41,41,83,44,
44,43,81,82,64,103,44,81,82,82,64,102,103,43,43,43,43,43,43,81,41,82,84,63,44,61,85,82,82,41,83,43,43,43,43,101,102,103,43,43,43,101,102,102,65,82,41,83,101,102,102,103,43,43,43,43,81,82,82,83,44,
44,61,85,82,83,43,44,81,41,82,83,43,44,44,44,44,44,44,44,81,82,82,41,83,44,81,41,41,64,102,44,44,44,44,44,44,44,44,44,44,44,44,44,62,85,82,82,83,44,44,44,44,44,44,44,43,81,41,41,83,44,
44,81,41,82,83,43,61,85,82,41,83,43,44,43,43,43,43,43,43,81,41,82,41,83,44,81,82,64,103,43,44,43,43,43,43,43,44,43,43,43,43,43,81,41,41,82,64,103,44,43,43,43,43,43,43,43,81,41,64,103,44,
44,81,41,82,84,62,85,82,82,64,103,43,44,43,43,43,61,62,62,85,41,41,82,83,44,101,102,103,43,43,44,43,61,62,63,43,44,43,43,61,62,62,85,41,64,102,103,43,44,43,43,61,62,62,62,62,85,41,84,63,44,
44,81,41,41,41,41,41,82,64,103,43,43,44,43,61,62,85,82,82,82,82,64,102,103,44,43,43,43,43,43,44,43,81,82,83,43,44,43,43,81,41,82,82,41,83,43,43,43,44,43,43,81,41,82,82,41,41,41,82,83,44,
44,101,102,102,102,102,102,102,103,43,43,43,44,61,85,82,82,41,82,64,102,103,43,43,44,43,61,62,62,63,44,43,81,82,83,43,44,43,43,81,82,41,82,41,83,43,43,43,44,43,43,81,41,82,82,64,102,102,102,103,44,
44,43,43,43,43,43,43,43,43,43,43,43,44,85,82,82,41,82,41,83,61,62,63,43,44,61,85,41,82,83,44,43,101,102,103,43,44,43,61,85,41,64,102,102,103,43,43,43,44,43,61,85,82,64,102,103,43,43,43,43,44,
44,44,44,44,44,44,44,44,44,44,44,44,44,82,41,82,41,82,44,104,85,41,83,43,44,85,41,82,41,84,44,43,43,61,62,63,44,61,85,41,41,83,44,44,44,44,44,44,44,62,85,41,41,84,44,44,44,44,44,44,44,
44,43,43,43,43,43,43,43,61,62,62,85,82,82,41,82,41,64,44,81,41,41,83,43,44,41,82,41,82,82,44,43,61,85,41,83,44,81,82,82,64,103,44,43,43,43,43,61,85,41,82,82,82,41,84,62,62,62,63,43,44,
44,43,61,62,62,63,43,61,85,82,41,82,82,41,82,64,102,103,44,81,41,41,83,43,44,41,82,82,82,41,44,43,81,41,41,83,44,81,41,64,103,43,44,43,43,43,43,81,41,82,41,82,41,41,82,82,41,82,83,43,44,
44,43,81,41,41,83,43,81,41,41,82,82,82,82,64,103,43,43,44,101,102,102,103,43,44,82,41,82,41,82,44,43,101,102,102,103,44,81,82,83,43,43,44,43,43,43,43,81,41,82,41,64,102,102,102,102,65,82,83,43,44,
44,43,101,102,102,103,43,81,82,82,82,41,41,64,103,43,43,43,44,43,43,43,43,43,44,41,41,41,41,41,44,43,43,43,43,43,44,81,82,84,63,43,44,43,43,43,43,101,102,102,102,103,43,43,43,43,101,102,103,43,44,
44,43,43,43,43,43,43,101,65,82,41,82,64,103,43,43,43,43,44,43,43,43,43,43,44,41,82,41,82,82,44,43,43,43,43,43,44,81,82,41,84,63,44,43,43,43,43,43,43,43,43,43,43,43,43,43,43,43,43,43,44,
44,61,62,62,63,43,44,61,85,82,41,64,44,44,44,44,44,44,44,44,44,44,44,44,44,41,41,41,64,102,44,43,61,62,63,43,44,101,65,82,82,83,44,44,44,44,44,44,44,44,44,44,44,44,44,44,44,44,44,44,44,
44,81,41,41,83,43,44,81,41,41,64,103,44,43,43,43,43,61,85,82,41,82,84,62,85,64,65,41,84,62,63,43,81,82,83,43,44,43,81,82,41,84,62,62,62,62,63,43,61,62,62,62,63,43,43,43,43,43,43,43,44,
44,81,82,82,83,43,44,101,102,102,103,43,44,43,61,62,62,85,82,82,41,82,82,41,82,84,85,41,41,41,84,62,105,102,103,43,44,61,85,41,41,82,41,82,82,41,84,62,85,82,41,82,83,43,61,62,63,43,43,43,44,
44,81,41,82,83,43,44,43,43,43,43,43,44,61,85,82,41,41,82,41,82,41,82,41,41,82,41,41,82,41,41,41,84,63,43,43,44,81,82,82,82,64,102,102,65,82,82,41,82,82,64,102,103,43,81,82,83,43,43,43,44,
44,81,41,41,83,43,44,43,61,62,63,43,44,81,82,41,64,102,102,65,82,82,82,64,65,41,82,64,102,102,65,41,41,84,63,43,44,101,65,41,41,83,43,43,101,102,102,102,102,102,103,43,43,43,81,82,84,62,63,43,44,
44,81,41,41,83,43,44,61,85,82,83,43,44,81,82,82,84,63,43,101,102,102,102,103,101,102,102,103,43,43,101,65,82,41,83,43,44,43,101,102,102,103,43,43,43,43,43,43,43,43,43,43,43,43,81,82,82,82,83,43,44,
44,81,82,64,103,43,44,81,41,82,83,43,44,81,82,82,41,83,44,44,44,44,44,44,44,44,44,44,44,44,44,101,102,102,103,43,44,44,44,44,44,44,44,44,44,44,44,44,44,44,44,44,44,44,44,102,102,102,103,43,44,
44,81,41,84,63,43,44,81,82,64,103,43,44,81,41,82,64,103,44,43,61,62,62,62,62,62,62,62,62,63,44,43,61,62,62,63,43,43,43,43,43,43,44,42,42,42,42,42,44,61,85,41,84,62,62,63,43,43,43,43,44,
44,85,82,41,83,43,44,101,102,103,43,43,44,81,82,64,103,43,44,43,81,82,41,82,82,41,82,82,82,84,44,43,81,41,41,83,43,43,43,43,43,43,44,42,42,42,42,42,44,81,82,41,41,41,82,84,63,43,43,43,44,
44,41,41,82,83,43,44,43,43,43,43,43,44,81,82,84,63,43,44,61,85,82,41,41,41,82,82,41,82,41,44,43,101,65,82,84,62,62,62,63,43,43,44,72,73,42,42,42,44,81,41,41,41,41,82,41,83,43,43,43,44,
44,82,82,82,83,43,44,43,43,43,43,43,44,81,41,41,84,62,44,81,82,41,41,41,82,64,65,82,41,82,44,43,43,81,41,82,41,82,82,84,63,43,44,43,93,42,42,42,44,81,82,82,82,82,41,64,103,43,43,43,44,
44,82,82,41,83,43,44,43,43,43,43,43,44,101,65,41,41,82,44,101,65,41,82,64,102,103,81,41,82,64,44,43,43,101,102,102,102,65,41,41,84,63,44,43,93,42,42,42,44,101,65,41,64,102,102,103,43,43,43,43,44,
44,82,41,82,83,43,44,44,44,44,44,44,44,43,81,41,82,64,44,43,81,41,82,83,44,61,85,41,82,83,44,44,44,44,44,44,44,81,82,82,82,83,44,43,94,73,42,42,44,43,81,41,84,62,44,44,44,44,44,44,44,
44,102,65,41,83,43,43,43,43,61,62,62,63,61,85,41,64,103,44,43,81,41,82,83,44,81,41,82,41,83,44,43,43,61,62,62,62,85,41,82,41,84,62,62,63,94,72,72,44,43,81,82,82,82,82,83,43,43,43,43,44,
44,43,81,41,84,62,62,62,62,85,82,41,84,85,82,41,83,43,44,43,101,65,82,83,44,81,41,82,41,83,44,43,43,81,82,82,41,82,82,82,41,41,41,82,84,62,63,43,44,43,81,41,82,82,82,84,62,62,63,43,44,
44,61,85,82,82,41,41,82,41,82,82,41,82,41,41,64,103,43,44,61,62,85,41,83,44,81,41,41,64,103,44,43,43,81,41,41,82,82,82,82,41,41,41,82,41,82,83,43,44,43,81,41,41,41,41,82,41,82,83,43,44,
44,81,82,82,82,82,64,102,102,102,65,41,82,41,64,103,43,43,44,81,41,41,82,83,44,101,65,82,83,43,44,43,43,101,102,102,102,102,65,82,41,64,65,41,82,41,83,43,44,43,101,102,102,102,102,65,41,41,84,63,44,
44,81,82,41,82,41,83,43,43,43,101,102,102,102,103,43,43,43,44,81,41,41,82,83,44,43,81,82,83,43,44,43,43,43,43,43,43,43,101,102,102,103,81,82,41,41,83,43,44,43,43,43,43,43,43,101,102,65,82,83,44,
44,81,41,82,41,64,44,44,44,44,44,44,44,44,44,44,44,44,44,101,65,41,82,83,44,61,85,41,83,43,44,44,44,44,44,44,44,44,44,44,44,44,44,102,65,82,83,43,44,44,44,44,44,44,44,43,43,81,82,83,44,
44,81,41,82,82,84,62,62,85,82,41,83,43,43,43,43,43,43,44,61,85,82,41,83,44,81,41,41,84,62,62,63,43,43,43,43,44,43,61,62,62,62,62,62,85,82,84,63,44,43,43,61,62,63,61,62,62,85,41,83,44,
44,81,41,41,82,82,41,82,82,82,82,84,62,62,62,62,63,43,44,81,41,82,64,103,44,81,41,82,82,82,82,84,62,62,62,63,44,43,81,41,41,41,41,41,41,82,41,83,44,43,43,81,41,84,85,82,82,41,82,83,44,
44,81,41,82,64,102,102,102,102,65,41,41,41,41,41,82,83,43,44,81,82,82,83,43,44,81,82,41,82,41,41,82,82,82,82,83,44,43,81,82,82,82,82,41,41,82,41,83,44,43,43,81,41,82,82,82,41,82,64,103,44,
44,81,82,64,103,43,43,61,62,85,82,82,82,82,41,64,103,43,44,81,82,41,83,43,44,101,102,102,102,102,102,65,41,82,41,83,44,43,101,102,102,102,102,102,102,102,102,103,44,61,62,85,82,64,102,65,41,64,103,43,44,
44,101,102,103,43,43,61,85,82,41,82,64,102,102,102,103,43,43,44,81,82,82,83,43,44,43,43,43,43,43,43,81,41,41,41,83,44,43,43,43,43,43,43,43,43,43,43,43,44,81,41,41,41,83,43,81,41,84,63,43,44,
44,44,44,44,44,44,44,82,41,41,64,103,44,44,44,44,44,44,44,81,82,41,83,43,44,44,44,44,44,44,44,81,82,82,64,103,44,44,44,44,44,44,44,44,44,44,44,44,44,101,65,82,41,83,44,81,82,41,84,63,44,
44,43,61,62,62,63,44,65,82,41,83,43,44,43,43,43,61,62,62,85,82,82,83,43,44,43,43,61,62,63,44,101,65,82,84,63,43,43,43,43,61,62,62,63,61,62,62,63,44,43,101,65,82,83,44,101,65,41,82,83,44,
44,61,85,82,41,83,44,101,65,41,83,43,44,43,61,62,85,82,41,82,41,82,83,43,44,43,61,85,41,83,44,43,81,82,82,84,62,62,62,62,85,41,82,84,85,41,41,83,44,61,62,85,82,83,44,43,81,82,82,83,44,
44,81,41,41,64,103,44,43,81,41,84,63,44,61,85,82,41,64,102,102,102,102,103,43,44,61,85,41,41,83,44,43,81,82,82,41,41,41,82,41,41,41,41,41,41,41,41,83,44,81,41,82,41,83,44,43,81,82,64,103,44,
44,81,41,64,103,43,44,43,81,41,82,83,44,81,82,41,64,103,43,43,43,43,43,43,44,81,41,41,64,103,44,43,81,82,82,41,82,64,102,102,102,65,82,41,82,82,41,83,44,81,41,64,102,103,44,43,101,102,103,43,44,
44,81,82,84,63,43,44,43,81,82,64,103,44,81,82,41,83,43,43,43,43,43,43,43,44,81,41,41,83,43,44,43,101,102,102,102,102,103,43,43,43,101,102,102,65,41,82,83,44,81,82,83,43,43,44,43,43,43,43,43,44,
44,81,82,41,84,63,44,43,81,82,83,43,44,81,41,41,84,62,44,44,44,44,44,44,44,81,41,41,83,43,44,44,44,44,44,44,44,44,44,44,44,44,44,43,81,41,82,83,44,81,82,84,62,62,44,44,44,44,44,44,44,
44,101,102,65,82,83,44,43,81,41,83,43,44,101,65,41,82,41,82,82,84,63,43,43,61,85,82,41,84,63,61,85,41,41,83,43,44,43,61,62,62,63,43,43,81,82,82,83,44,81,82,41,41,41,83,43,43,43,43,43,44,
44,43,61,85,41,83,44,43,81,82,84,63,44,43,81,82,82,64,65,82,82,84,62,62,85,41,41,41,41,84,85,41,82,41,83,43,44,61,85,41,82,84,62,62,85,82,41,83,44,81,82,82,41,41,84,62,62,63,43,43,44,
44,61,85,82,41,83,44,61,85,41,82,83,44,43,81,41,41,83,81,41,82,41,41,82,82,41,41,82,41,41,41,82,41,82,83,43,44,81,41,82,82,82,41,41,41,82,64,103,44,101,102,102,65,82,41,82,41,84,62,63,44,
44,81,41,82,64,103,44,81,82,41,64,103,44,43,101,102,102,103,101,102,102,102,65,41,82,64,102,102,102,102,65,41,82,82,83,43,44,81,41,64,102,102,102,102,102,102,103,43,44,43,43,43,101,102,102,65,82,41,41,83,44,
44,81,41,82,83,43,44,81,41,64,103,43,44,43,43,43,43,43,43,43,43,43,101,102,102,103,43,43,43,43,81,82,41,41,83,43,44,101,102,103,43,43,43,43,43,43,43,43,44,43,43,43,43,43,43,81,82,82,41,83,44,
44,81,41,82,83,43,44,81,41,83,43,43,44,44,44,44,44,44,44,44,44,44,44,44,44,44,44,44,44,44,44,65,82,41,83,43,44,44,44,44,44,44,44,44,44,44,44,44,44,44,44,44,44,44,44,81,41,41,64,103,44,
44,101,65,41,84,63,43,81,82,83,43,43,43,43,43,43,43,61,85,89,68,42,42,42,42,42,42,42,42,42,44,81,41,41,84,62,62,62,62,62,62,62,62,63,43,43,61,62,63,43,61,62,63,43,61,85,82,64,103,43,44,
44,43,101,65,82,83,43,81,41,83,61,62,62,62,62,63,43,81,82,82,88,42,42,42,42,42,42,42,42,42,44,101,65,82,82,41,82,82,82,41,82,41,82,84,63,43,81,41,84,62,85,41,83,43,81,82,82,83,43,43,44,
44,43,43,101,102,103,43,81,82,83,81,41,82,82,82,84,62,85,82,41,89,67,67,67,67,67,67,67,67,67,44,43,101,65,41,41,82,82,82,41,41,41,82,82,84,62,85,41,41,41,82,41,84,62,85,82,41,84,63,43,44,
44,43,43,43,43,43,43,101,102,103,101,102,102,65,41,82,41,82,41,82,64,102,102,102,65,82,41,82,64,103,44,43,43,101,102,102,102,102,65,82,82,64,65,82,82,41,82,82,64,65,41,41,41,41,41,82,41,41,83,43,44,
44,43,43,43,43,43,43,43,43,43,43,43,43,101,102,102,102,102,102,102,103,43,43,43,101,102,102,102,103,43,44,43,43,43,43,43,43,43,101,102,102,103,101,102,102,102,102,102,103,101,102,102,102,102,102,102,102,102,103,43,44,
44,44,44,44,44,44,44,44,44,44,44,44,44,44,44,44,44,44,44,44,44,44,44,44,44,44,44,44,44,44,44,44,44,44,44,44,44,44,44,44,44,44,44,44,44,44,44,44,44,44,44,44,44,44,44,44,44,44,44,44,44
      ],
  "objects": [
    {
      "walkable": false,
      "tile": 23,
      "x": 64,
      "y": 64,
      "height":32,
      "width":32
    },
    {
      "tile": 23,
     "walkable": false,
     "height":32,
     "width":32,
     "x":352,
     "y":385.333333333333
    },
    {
      "tile": 23,
     "walkable": false,
     "height":32,
     "width":32,
     "x":370.666666666667,
     "y":45.3333333333333
    },
    {
      "tile": 23,
     "walkable": false,
     "height":32,
     "width":32,
     "x":465.333333333333,
     "y":41.3333333333333
    },
    {
      "tile": 23,
     "walkable": false,
     "height":32,
     "width":32,
     "x":708,
     "y":500
    },
    {
      "tile": 23,
     "walkable": false,
     "height":32,
     "width":32,
     "x":629.333333333333,
     "y":1200
    },
    {
      "tile": 23,
     "walkable": false,
     "height":32,
     "width":32,
     "x":220,
     "y":1485.33333333333
    },
    {
      "tile": 23,
     "walkable": false,
     "height":32,
     "width":32,
     "x":1100,
     "y":1913.33333333333
    },
    {
      "tile": 22,
     "walkable": false,
     "height":32,
     "width":32,
     "x":77.3333333333333,
     "y":505.333333333333
    },
    {
      "tile": 22,
     "walkable": false,
     "height":32,
     "width":32,
     "x":93.3333333333333,
     "y":522.666666666667
    },
    {
      "tile": 22,
     "walkable": false,
     "height":32,
     "width":32,
     "x":104,
     "y":497.333333333333
    },
    {
      "tile": 22,
     "walkable": false,
     "height":32,
     "width":32,
     "x":136,
     "y":516
    },
    {
      "tile": 22,
     "walkable": false,
     "height":32,
     "width":32,
     "x":149.333333333333,
     "y":486.666666666667
    },
    {
      "tile": 22,
     "walkable": false,
     "height":32,
     "width":32,
     "x":328,
     "y":384
    }]
}