{
  "tileset": "ts1",
  "cols": 20,
  "rows": 20,
  "cells": [
    [81,81,81,81,81,81,81,81,81,81,88,66,67,41,41,41,41,41,41,41],
    [81,81,81,81,81,81,81,81,81,81,81,81,88,67,41,41,41,41,41,41],
    [81,81,81,81,81,81,81,81,81,81,81,81,81,88,66,67,41,41,41,41],
    [81,81,81,81,81,81,81,81,81,81,81,81,81,81,81,88,66,67,41,41],
    [81,81,81,81,81,81,81,81,81,81,81,81,81,81,81,81,81,88,67,41],
    [81,81,81,81,81,81,81,81,81,81,81,81,81,81,81,81,81,81,87,41],
    [81,81,81,81,81,81,81,81,81,81,81,81,81,81,81,81,81,81,88,66],
    [81,81,81,81,81,81,81,81,81,81,81,81,81,81,81,81,81,81,81,81],
    [81,81,81,81,81,81,81,81,81,81,81,81,81,81,81,81,81,81,81,81],
    [81,81,81,81,81,81,81,81,81,81,81,81,81,81,81,81,81,81,81,81],
    [81,81,81,81,81,81,81,81,81,81,81,81,81,81,81,81,81,81,81,81],
    [81,81,81,81,81,81,81,81,81,81,81,81,81,81,81,81,81,81,81,81],
    [81,81,81,81,81,81,81,81,81,81,81,81,81,81,81,81,81,81,81,81],
    [81,81,81,81,81,81,81,81,81,81,81,81,81,43,43,42,42,43,43,43],
    [81,81,81,81,81,81,81,81,81,81,81,81,81,43,42,42,42,42,42,42],
    [81,81,81,81,81,81,81,81,81,81,81,81,81,43,42,42,42,42,42,42],
    [81,81,81,81,81,81,81,81,81,81,81,81,81,43,42,42,42,42,42,42],
    [81,81,81,81,81,81,81,81,81,81,81,81,81,43,42,42,42,42,42,42],
    [81,81,81,81,81,81,81,81,81,81,81,81,81,43,42,42,42,42,42,42],
    [81,81,81,81,81,81,81,81,81,81,81,81,81,43,42,42,42,42,42,42]
  ],
  "objects": [
    {
      "walkable": false,
      "tile": 21,
      "pos": [2, 2]
    }
  ]
}