{
  "tileset": "ts1",
  "cols": 20,
  "rows": 20,
  "encoding": "matrix",
  "data": [
    [44,44,44,44,44,44,82,82,82,82,89,67,68,42,42,42,42,42,42,42],
    [82,82,82,82,82,44,82,82,82,82,82,82,89,68,42,42,42,42,42,42],
    [82,82,82,82,82,44,82,82,82,82,82,82,82,89,67,68,42,42,42,42],
    [82,82,82,82,82,44,82,82,82,82,82,82,82,82,82,89,67,68,42,42],
    [82,82,82,82,82,44,82,82,82,82,82,82,82,82,82,82,82,89,68,42],
    [82,82,82,82,82,44,44,44,44,44,44,44,82,82,82,82,82,82,88,42],
    [82,82,82,82,82,44,82,82,82,82,82,82,82,82,82,82,82,82,89,67],
    [82,82,82,82,82,44,82,82,82,82,82,82,82,82,82,82,82,82,82,82],
    [82,82,82,82,82,44,82,82,82,82,82,82,82,82,82,82,82,82,82,82],
    [82,82,82,82,82,44,82,82,82,82,82,82,82,82,82,82,82,82,82,82],
    [82,82,82,82,82,44,82,82,82,82,82,82,82,82,82,82,82,82,82,82],
    [82,82,82,82,82,82,82,82,82,82,82,82,82,82,82,82,82,82,82,82],
    [82,82,82,82,82,82,82,82,82,82,82,82,82,82,82,82,82,82,82,82],
    [82,82,82,82,82,82,82,82,82,82,82,82,82,44,44,43,43,44,44,44],
    [82,82,82,82,82,82,82,82,82,82,82,82,82,44,43,43,43,43,43,43],
    [82,82,82,82,82,82,82,82,82,82,82,82,82,44,43,43,43,43,43,43],
    [82,82,82,82,82,82,82,82,82,82,82,82,82,44,43,43,43,43,43,43],
    [82,82,82,82,82,82,82,82,82,82,82,82,82,44,43,43,43,43,43,43],
    [82,82,82,82,82,82,82,82,82,82,82,82,82,44,43,43,43,43,43,43],
    [82,82,82,82,82,82,82,82,82,82,82,82,82,44,43,43,43,43,43,43]
  ],
  "objects": [
    {
      "walkable": false,
      "tile": 22,
      "pos": [2, 2]
    },
    {
      "walkable": false,
      "animation": "fire",
      "pos": [0, 0]
    },
    {
      "walkable": false,
      "animation": "fire",
      "pos": [5, 0]
    },
    {
      "walkable": false,
      "animation": "fire",
      "pos": [13, 13]
    },
    {
      "walkable": false,
      "animation": "fire",
      "pos": [14, 13]
    },
    {
      "walkable": false,
      "animation": "fire",
      "pos": [18, 13]
    },
    {
      "walkable": false,
      "animation": "fire",
      "pos": [13, 19]
    }
  ]
}